111111111111111111111111111111111111111111111111111111111
100000000000000000000000000000000000000000000000000000001
100000000000000000000000000000000000000000000000000000001
100000000000000000000000001000000000000000000000000000001
10000000000000000000000001P000000000000000000000000000001
100000000000000000000000001000000000000000000000000000001
10000000000000000000000001C000000000000000000000000000001
100000000000000000000000001000000000000000000000000000001
100000000000000000000000000000000000001000000000000000001
10000000000000000000000000000000000001E000000000000000001
100000000000000000000000000000000000001000000000000000001
100000000000000000000000000000000000000000000000000000001
100000000000000000000000000000000000000000000000000000001
100000000000000000000000000000000000000000000000000000001
100000000000000000000000000000000000000000000000000000001
100000000000000000000000000000000000000000000000000000001
100000000000000000000000000000000000000000000000000000001
100000000000000000000000000000000000000000000000000000001
100000000000000000000000000000000000000000000000000000001
100000000000000000000000000000000000000000000000000000001
100000000000000000000000000000000000000000000000000000001
100000000000000000000000000000000000000000000000000000001
100000000000000000000000000000000000000000000000000000001
100000000000000000000000000000000000000000000000000000001
100000000000000000000000000000000000000000000000000000001
111111111111111111111111111111111111111111111111111111111